4 4
11000000
11110110
11110110
11000000
00000000
00110000
00110000
00000000
