6 3
002222011000
002332011000
110330111111
110220111111
000001101111
001101101111
001100000000
