17 8
0000000000000000000000000022000000
0000000000000000000000000022220000
0000000000000000000000000000222200
0000000000000000000000000000002200
0000000000000000111111111111000022
0000000000000011111111111111000022
0011111111000011222222222222110011
0011111111001122222222222222110011
1111222211001122333333333333221100
1111333311001133344444444443221100
1122333322001133344444444443221100
1122333322001122333333333333221100
1111333311001122222222222222111100
1111222211110011222222222222111100
0011111111110011111111111111110000
0011111111000000111111111111110000
