15 8
001122110000000000000011221100
111122113300000000003311221111
110000003322334433223300000011
220022000022334433220000220022
220022000033000000330000220022
220000000033000000330000000022
222244332233002200332233442222
002244332233002200332233442200
000000330033000000330033000000
000000330033000000330033000000
000044222233333333332222440000
000044222233333333332222440000
000033000000000000000000330000
000033002200220022002200330000
000022112211221122112211220000
000022110011001100110011220000
