15 8
0000022330002200220003322000000
0000022330002200220003322000000
0000000220000111100002200000000
0330000223300111100332200003300
0332200003311222211330000223300
0002233330011222211003333220000
0000033331122333322113333000000
0000000001122333322110000000000
0000000011223344332211000000000
3322332211223355332211223322330
3322332201122355322110223322330
0000000001122344322110000000000
0000000220011222211002200000000
0000033220011222211002233000000
0332233000000111100000033223300
0332200000000111100000000223300
