11 8
4433330000000000333344
4433330000000000333344
3300330000000000330033
3300333322332233330033
2233443322332233443322
2233442200000022443322
0000002200000022000000
0000003300000033000000
0000003300000033000000
0000002200000022000000
4433332200000022333344
4433333322332233333344
3300333322332233330033
3300330000000000330033
4433440000000000443344
4433440000000000443344
