15 8
001111111111111111111111110000
001111111111111111111111110000
000000112222222222221100000000
000000112222222222221100000000
000011112233333333221111000000
000011112233333333221111000000
001111112233444433221111110000
111111112233455433221111111111
111111112233455433221111111111
001111112233444433221111110000
000011112233333333221111000000
000011112233333333221111000000
000000112222222222221100000000
000000112222222222221100000000
001111111111111111111111110000
001111111111111111111111110000